|^^^^^^^^^^^^^^^^^^^^^^^^^|
| a                       |
| A                       |
|##### # # ## # # ###    c|
|                    #    |
|              x x     xx |
|       ##cc##############|
|   #####     c c c       |
|##          ########     |
|@## c  x    #        ##  |
| ########## #   x ####  #|
|   c           xx cccc#  |
|       xx c   xxx       x|
mmmmmm mmmm mmmmmmmm mmmmmm