>                         <
> a                       <
> A T c c c  c c c        <
>##### # # ## # # ###    c<
>                    #    <
>              x x     xx <
>       ##cc##############<
>   #####     c c c       <
>##          ########     <
> ## c  x    #        ##  <
> ########## #   x ####  #<
>   c           xx cccc#  <
>@      xx c   xxx       x<
mmmmmb~dmmb~dmmmmmmb~dmmmmm